..............................................................................................
..............................................................................................
.........#################...................................###############################..
.........#################...................................###############################..
.........##.............##...................................##...........................##..
.........##....@........##...................................##...........................##..
.........##.............##...................................##......A....................##..
.........##.............##...................................##...........................##..
.........##.............##...................................##...........................##..
.........##.............##...................................##...........................##..
.........##.............##...................................##...........................##..
.........##.............##...................................##...........................##..
.........##.............##...................................##...........................##..
.........##.............##...................................##...........................##..
...########.............#######################################...........................##..
...########.............#######################################...........................##..
...##........................................................##...........................##..
...##........................................................##...........................##..
...##.....................................................................................##..
...##.....................................................................................##..
...##.....................................................................................##..
...##........................................................##...........................##..
...##........................................................##...........................##..
...#########################################################################################..
...#########################################################################################..
..............................................................................................
..............................................................................................
..............................................................................................
..............................................................................................
